1111111111111111111111111111111
1P0100000000000000000N0000000C1
1000000000000000000000000000001
1000000000000100000000000000001
1000010000000101010101001101111
10010111100001C1C1C1C10011000E1
1111111111111111111111111111111